10 10
##########
#        #
#    #####
#    # * #
#    #   #
#    #   #
#   ##   #
#        #
#        #
##########
